tay	SquliqAtayal
tay	CiuliAtayal
trv	Sediq
bnn	Bunun
ami	CentralAmis
ckv	Kavalan
byq	Basai
fos	Siraya
xsy	Saisiat
pwn	Paiwan
uun	Pazeh
pyu	Puyuma
dru	Rukai
tsu	Tsou
xnb	Kanakanabu
sxr	Saaroa
bzg	Favorlang
ssf	Thao
ban	Bali
sas	Sasak
mhy	Maanyan
plt	MerinaMalagasy
tjg	Tunjung
nij	Katingan
nij	DayakNgaju
txn	NgaiborSAru
udj	UjirNAru
ddw	DaweraDaweloor
dij	Dai
bcd	NorthBabar
vbb	SouthEastBabar
sve	Serili
vme	EastMasela
mxz	CentralMasela
emw	Emplawas
tvm	TelaMasbuar
imr	Imroing
bhp	Bima
xbr	Kambera
mqy	Manggarai
nxg	Ngadha
hvn	Savu
kod	Kodi
wnk	Wanukaka
akg	Anakalang
lmy	LamboyaLaboya
mvd	Mamboru
kod	GauraNggaura
wew	WejewaTanaRighu_D
ssq	Soa
xbr	ESKamberaSouthern_D
xbr	ESLewa_D
xbr	ESUmbuRatuNggai_D
ljl	LioFloresTongah
XXX	Pondok
XXX	Baliledo
mhs	BuruNamroleBay
bnd	ElatKeiBesar
ges	Geser
wah	Watubela
bty	Bobot
bty	Werinama
bnf	Masiwang
bnf	Bonfia
htu	HituAmbon
plh	Paulohi
alp	MurnatenAlune
alp	Alune
tlv	Soboyo
skz	Sekar
kwh	KoiwaiIrianJaya
kei	KeiTanimbarKei
jmd	Yamdena
slu	Selaru
slp	Lamaholot
ski	Sika
ksx	Kedang
kem	Kemak
mgm	Mambai
aoz	Atoni
twu	RotiTermanu_D
kje	Kisar
lti	Letinese
lex	Luang
srw	Serua
nil	Nila
tve	Teun
ilu	Erai
ilu	Iliun
tzn	Tugun
wet	Perai
apx	Aputai
gal	Talur
lek	Leipon
los	Loniu
tlx	Levei
lib	Likum
loj	Lou
ncn	Nauna
ssg	Seimat
wuv	Wuvulu
fij	FijianBau
mrq	Marquesan
haw	Hawaiian
mrv	Mangareva
rar	Rarotongan
mri	Maori
aut	Rurutuan
tah	TahitianModern
pnh	Penrhyn
pmt	Tuamotu
rap	RapanuiEasterIsland
wls	UveaEast
nkr	Nukuoro
tvl	Tuvalu
kpg	Kapingamarangi
ojv	Luangiua
sky	Sikaiana
nho	Takuu
tkp	Tikopia
fut	Futuna
mnv	Rennellese
fud	FutunaEast
mmw	Emae
mxe	IfiraMeleMeleFila
aud	Anuta
uve	UveaWest
fut	FutunaWest
piv	VaeakauTaumako
cha	Chamorro
smo	Samoan
tkl	Tokelau
ton	Tongan
niu	Niue
rtm	Rotuman
utp	Nembao
aua	Asumboa
tbe	Tanimbili
tkw	Teanu
tkw	Buma
vnk	Vano
tnx	Tanema
nen	Nengone
dhv	Dehu
iai	Iaai
nee	Nelemwa
jaz	Jawe
ane	Canala
gil	Kiribati
kos	Kusaie
mah	MarshalleseE_D
mah	Marshallese
pon	Ponapean
mkj	Mokilese
chk	Chuukese
woe	Woleai
cal	Carolinian
puw	Puluwatese
sov	PuloAnnan
cal	SaipanCarolinian
stw	Satawalese
mrl	Mortlockese
woe	Woleaian
chk	ChuukeseAKATrukese
mlv	Mwotlap
mtt	Mota
sku	SakaoPortOlry
mwo	PeteraraMaewo
lmb	Merei
akr	ArakiSouthwestSanto
lml	Raga
XXX	Nese
mrs	Tape
lzl	Naman
tmb	Avava
vnm	Neveei
XXX	Nati
sns	Nahavaq
XXX	Orkon
tvk	AmbrymSouthEast
pma	PaameseSouth
nmk	Namakir
llp	Nguna
erk	SouthEfate
erg	SyeErromangan
uur	Ura
tnl	Lenakel
nwi	TannaSouthwest
tnk	Kwamera
aty	AnejomAneityum
bgt	Bugotu
nlg	Nggela
gri	GhariGuadalcanal
tlr	Tolo
kwd	Kwaio
llu	Lau
kwf	KwaraaeSolomonIslands
mlu	Toambaita
apb	Saa
stn	SantaAna
emi	Mussau
wiv	Vitu
tbf	Tabar
tgc	Tigak
lcm	TungagTungakLavongai
nal	Nalik
tbf	Madara
leu	KaraWest
tbj	Tiang
baa	Babatana
tva	VaghuaChoiseul
rri	Ririo
vrs	Varisi
baa	Sisingga
vmg	LungaLungaMinigir
nsn	NehanHape
nsn	Nissan
tio	Teop
sps	Taiof
mvo	MarovoNewGeorgia
hoa	HoavaNewGeorgia
rug	Roviana
sbb	Simbo
gfk	Patpatar
sjr	Siar
ksd	Kuanua
bcm	Banoni
jaj	KilokakaYsabel
kkk	Kokota
mrn	ChekeHolo
kji	KiaZabana
nak	NakanaiBileki_D
nak	Lakalai
nak	Maututu
sij	NumbamiSiboma
kvc	Kove
gdd	Gedaged
tbc	Megiar
mjk	Matukar
brz	Bilibil
mgl	Maleu
ssz	Sengseng
mwh	Mouk
mwh	Aria
kxa	Kairiru
woc	Wogeo
mva	Manam
pwg	Gapapaiwa
ubr	Ubir
bwd	Bwaidoga
mox	Molima
ddi	Diodio
dob	Dobuan
swp	Suau
sbe	Saliba
zgr	MagoriSouthEastPapua
meu	Motu
mek	Mekeo
kij	Kilivila
irh	KasiraIrahutu
gzn	Giman
bzq	Buli
bhw	Numfor
mhz	Mor
xmt	BigaMisool
gei	MinyaifuinGebe
asz	As
wrp	Waropen
amk	AmbaiYapen
wad	WindesiWandamen
gay	Gayo
jav	Javanese
jav	OldJavanese
ree	KayanUmaJuman
sge	PunanKelai
mxd	Modang
bvk	Bukat
ljp	Lampung
kge	Komering
sne	Singhi
bei	DayakBakatiqSaraRiok
mad	Madurese
huq	HainanCham
cjm	PhanRangChamEasternCham
cje	Chru
kvr	Kerinci
pse	Ogan
bjn	BanjareseMalay
ind	MalayBahasaIndonesia
kxd	MelayuBrunei_D
ind	Indonesian
ind	Melayu
min	Minangkabau
iba	Iban
bpr	KoronadalBlaan
mwt	Moken
bcl	BikolNagaCity
ceb	Cebuano
tsg	TausugJolo_D
sgd	Surigaonon
akl	AklanonBisayan
mmn	Mamanwa
msk	Mansaka
kqe	Kalagan
tgl	Tagalog
tgt	TagbanwaAborlan_D
tbk	TagbanwaKalamianCoronIsland_D
plw	PalawanBatak
hnn	Hanunoo
ivv	Itbayaten
ivv	Iraralay
ivv	Itbayat
ivv	Imorod
ivv	Ivasay
ivv	Isamorong
ivv	Babuyan
tao	Yami
pam	Kapampangan
sbl	SambalBotolan
ilo	Ilokano
agt	Agta
dgc	DumagatCasiguran
gad	Gaddang
ibg	Ibanag
att	AttaPamplona
isd	IsnegDibagatKabugaoIsneg
itb	ItnegBinongan
knb	KalingaGuinaangLubuagan_D
blw	Balangaw
lbk	BontokGuinaang
xnn	KankanayNorthern
ifa	IfugaoAmganad
ifb	IfugaoBatad
ilk	KakidugenIlongot
pag	Pangasinan
ibl	Inibaloi
ify	IfugaoBayninan
kak	KallahanKayapaProper
ify	KallahanKeleyqiq
lhn	Lahanan
mel	MelanauMukah
zbw	BerawanLongTerawan
beg	Belait
bny	Bintulu
kzi	KelabitBario
tih	TimugonMurut
xky	KenyahLongAnap
dbj	Idaan
pau	Palauan
abx	Inabaknon
bdl	Bajo
sjm	Mapun
sml	SamalSiasi_D
yka	Yakan
bps	SaranganiBlaan
tbl	TboliTagabili
mrw	Maranao
mbd	ManoboDibabawon
atd	ManoboAtaupriver
atd	ManoboAtadownriver
mbt	ManoboTigwaIglogsad_D
mbb	WBukidnonManobo
mbi	ManoboIlianenKibudtungan_D
bkd	Binukid
mta	ManoboKalamansigCotabatoParil_D
mbs	ManoboSaranganiKayaponga_D
syb	SubanunSindangan
suc	SubanonSiocon
xmz	Mori
gor	GorontaloHulondalo
kzp	Kaidipang
mog	BolaangMongondow
pmf	Baree
tnt	Tontemboan
mnb	MunaKatobuTongkuno_D
mnb	Wuna
bna	Bonerate
bhq	Popalia
bgz	BanggaiW_D
sxn	Sangir
snl	SangilSaraganiIslands
sxn	SangirTabukang_D
bnq	Bantik
bug	BugineseSoppeng_D
emb	Maloh
mak	Makassar
rob	TaeSToraja
wlo	Wolio
bbc	TobaBatak
nia	Nias
sun	Sunda
rej	RejangRejang
abs	MelayuAmbon
tet	Tetum
nfl	Aiwoo
ngr	Nanggu
ntu	MaloSantaCruz
ntu	LwepeSantaCruz
och	OldChinese
yzg	Buyang
